game_id,season,week,away_team,away_score,home_team,home_score,result,total,overtime,spread_line,Proj_Margin,abs_error,vegas_abs_error,sqd_error,vegas_sqd_error,straight_up_win,vegas_straight_up_win,ATS_win,AE_ATS_win
2025_01_DAL_PHI,2025,1,DAL,20,PHI,24,4,44,0,8.5,8.10749057492577,4.1074905749257695,4.5,16.871478823104027,20.25,1,1,1,1
2025_01_KC_LAC,2025,1,KC,21,LAC,27,6,48,0,-3,-1.3707119522483824,7.370711952248382,9,54.32739468301716,81,0,0,1,1
2025_01_TB_ATL,2025,1,TB,23,ATL,20,-3,43,0,-1.5,-0.8522800181455756,2.1477199818544244,1.5,4.6127011204567685,2.25,1,1,0,0
2025_01_CIN_CLE,2025,1,CIN,17,CLE,16,-1,33,0,-5.5,-2.0188403509965216,1.0188403509965216,4.5,1.0380356608187151,20.25,1,1,1,1
2025_01_MIA_IND,2025,1,MIA,8,IND,33,25,41,0,1.5,-0.8175135275189127,25.817513527518912,23.5,666.544004743622,552.25,0,1,0,0
2025_01_CAR_JAX,2025,1,CAR,10,JAX,26,16,36,0,4.5,4.193423381678485,11.806576618321516,11.5,139.3952514442963,132.25,1,1,0,0
2025_01_LV_NE,2025,1,LV,20,NE,13,-7,33,0,2.5,1.8969328014430027,8.896932801443002,9.5,79.15541327339243,90.25,0,0,1,1
2025_01_ARI_NO,2025,1,ARI,20,NO,13,-7,33,0,-6,1.4045642037070027,8.404564203707002,1,70.63669945423311,1,0,1,0,0
2025_01_PIT_NYJ,2025,1,PIT,34,NYJ,32,-2,66,0,-3,0.39922626794780425,2.399226267947804,1,5.756286684810748,1,0,1,1,0
2025_01_NYG_WAS,2025,1,NYG,6,WAS,21,15,27,0,6,4.890305761000967,10.109694238999031,9,102.20591760605024,81,1,1,0,0
2025_01_TEN_DEN,2025,1,TEN,12,DEN,20,8,32,0,8.5,4.101603572980551,3.898396427019449,0.5,15.197494702198007,0.25,1,1,1,0
2025_01_SF_SEA,2025,1,SF,17,SEA,13,-4,30,0,-2.5,1.0217955595666974,5.021795559566698,1.5,25.218430642083803,2.25,0,1,0,0
2025_01_DET_GB,2025,1,DET,13,GB,27,14,40,0,1.5,-0.6948230932228263,14.694823093222826,12.5,215.9378257411149,156.25,0,1,0,0
2025_01_HOU_LA,2025,1,HOU,9,LA,14,5,23,0,3.5,1.758093307146844,3.241906692853156,1.5,10.509959005166086,2.25,1,1,0,0
2025_01_BAL_BUF,2025,1,BAL,40,BUF,41,1,81,0,-1.5,3.179988100154886,2.179988100154886,2.5,4.7523481168169095,6.25,1,0,1,1
2025_01_MIN_CHI,2025,1,MIN,27,CHI,24,-3,51,0,-1.5,0.6009081189971183,3.6009081189971184,1.5,12.966539281459363,2.25,0,1,0,0
2025_02_WAS_GB,2025,2,WAS,18,GB,27,9,45,0,3.5,2.6971179606234994,6.302882039376501,5.5,39.72632200229488,30.25,1,1,0,0
2025_02_CLE_BAL,2025,2,CLE,17,BAL,41,24,58,0,12.5,5.1831009914241495,18.816899008575852,11.5,354.0756882989429,132.25,1,1,0,0
2025_02_JAX_CIN,2025,2,JAX,27,CIN,31,4,58,0,3.5,1.60831459895362,2.39168540104638,0.5,5.720159057578384,0.25,1,1,0,0
2025_02_NYG_DAL,2025,2,NYG,37,DAL,40,3,77,1,4.5,1.4968368955350648,1.5031631044649352,1.5,2.2594993186246617,2.25,1,1,1,0
2025_02_CHI_DET,2025,2,CHI,21,DET,52,31,73,0,6,7.942763019943612,23.057236980056388,25,531.6361771544798,625,1,1,1,1
2025_02_NE_MIA,2025,2,NE,33,MIA,27,-6,60,0,1.5,-2.392440849113581,3.607559150886419,7.5,13.01448302714434,56.25,1,0,1,1
2025_02_SF_NO,2025,2,SF,26,NO,21,-5,47,0,-3,0.5170721597049326,5.517072159704933,2,30.43808521539125,4,0,1,0,0
2025_02_BUF_NYJ,2025,2,BUF,30,NYJ,10,-20,40,0,-6,-2.6816791628573693,17.31832083714263,14,299.92423661820857,196,1,1,0,0
2025_02_SEA_PIT,2025,2,SEA,31,PIT,17,-14,48,0,3.5,4.6531593104248286,18.65315931042483,17.5,347.9403522600885,306.25,0,0,0,0
2025_02_LA_TEN,2025,2,LA,33,TEN,19,-14,52,0,-5.5,1.931884444172189,15.931884444172187,8.5,253.82494194245575,72.25,0,1,0,0
2025_02_CAR_ARI,2025,2,CAR,22,ARI,27,5,49,0,7,7.039793370939757,2.0397933709397567,2,4.160756996129776,4,1,1,0,0
2025_02_DEN_IND,2025,2,DEN,28,IND,29,1,57,0,-2.5,8.879549601045476,7.8795496010454755,3.5,62.087301915335914,12.25,1,0,1,0
2025_02_PHI_KC,2025,2,PHI,20,KC,17,-3,37,0,-1.5,-0.48990036807077786,2.510099631929222,1.5,6.300600162211216,2.25,1,1,0,0
2025_02_ATL_MIN,2025,2,ATL,22,MIN,6,-16,28,0,3.5,3.2859302916751725,19.28593029167517,19.5,371.947107215354,380.25,0,0,1,1
2025_02_TB_HOU,2025,2,TB,20,HOU,19,-1,39,0,2.5,4.939848044863973,5.939848044863973,3.5,35.281794796074365,12.25,0,0,0,0
2025_02_LAC_LV,2025,2,LAC,20,LV,9,-11,29,0,-3.5,-2.675618950114899,8.324381049885101,7.5,69.29531986368617,56.25,1,1,0,0
2025_03_MIA_BUF,2025,3,MIA,21,BUF,31,10,52,0,12.5,11.583467429497224,1.5834674294972242,2.5,2.5073691002785465,6.25,1,1,1,1
2025_03_ATL_CAR,2025,3,ATL,0,CAR,30,30,30,0,-5.5,-4.752791839281063,34.75279183928106,35.5,1207.7565406244005,1260.25,0,0,1,1
2025_03_GB_CLE,2025,3,GB,10,CLE,13,3,23,0,-8.5,-10.516388190509506,13.516388190509506,11.5,182.6927497165448,132.25,0,0,0,0
2025_03_HOU_JAX,2025,3,HOU,10,JAX,17,7,27,0,1.5,-4.102041998325841,11.10204199832584,5.5,123.25533653259085,30.25,0,1,0,0
2025_03_CIN_MIN,2025,3,CIN,10,MIN,48,38,58,0,3,11.19578830256592,26.80421169743408,35,718.465764720862,1225,1,1,1,1
2025_03_PIT_NE,2025,3,PIT,21,NE,14,-7,35,0,-1.5,3.897930096772986,10.897930096772988,5.5,118.76488039415048,30.25,0,1,0,0
2025_03_LA_PHI,2025,3,LA,26,PHI,33,7,59,0,3.5,1.115052276718051,5.8849477232819485,3.5,34.63260970576139,12.25,1,1,0,0
2025_03_NYJ_TB,2025,3,NYJ,27,TB,29,2,56,0,6.5,-5.749884568710135,7.749884568710135,4.5,60.06071082833147,20.25,0,1,1,0
2025_03_IND_TEN,2025,3,IND,41,TEN,20,-21,61,0,-6,-7.344971271423583,13.655028728576417,15,186.45980957824727,225,1,1,1,1
2025_03_LV_WAS,2025,3,LV,24,WAS,41,17,65,0,2.5,8.394207586454662,8.605792413545338,14.5,74.05966306503448,210.25,1,1,1,1
2025_03_DEN_LAC,2025,3,DEN,20,LAC,23,3,43,0,2.5,9.547954165548475,6.547954165548475,0.5,42.87570375412363,0.25,1,1,1,0
2025_03_NO_SEA,2025,3,NO,13,SEA,44,31,57,0,7.5,3.680568989120122,27.31943101087988,23.5,746.3513107582252,552.25,1,1,0,0
2025_03_DAL_CHI,2025,3,DAL,14,CHI,31,17,45,0,-1.5,4.436748879184396,12.563251120815604,18.5,157.83527872467454,342.25,1,0,1,1
2025_03_ARI_SF,2025,3,ARI,15,SF,16,1,31,0,1.5,-0.7449433817889064,1.7449433817889064,0.5,3.0448274056489053,0.25,0,1,1,0
2025_03_KC_NYG,2025,3,KC,22,NYG,9,-13,31,0,-6,-1.935050955896628,11.064949044103372,7,122.43309734860412,49,1,1,0,0
2025_03_DET_BAL,2025,3,DET,38,BAL,30,-8,68,0,4.5,0.33160525611601255,8.331605256116013,12.5,69.41564614373998,156.25,0,0,1,1
2025_04_SEA_ARI,2025,4,SEA,23,ARI,20,-3,43,0,-1.5,3.0831922604712094,6.083192260471209,1.5,37.00522807785682,2.25,0,1,0,0
2025_04_MIN_PIT,2025,4,MIN,21,PIT,24,3,45,0,-2.5,-1.0634994506688376,4.0634994506688376,5.5,16.512027785585946,30.25,0,0,1,1
2025_04_WAS_ATL,2025,4,WAS,27,ATL,34,7,61,0,2.5,2.594994647403727,4.405005352596273,4.5,19.404072156401817,20.25,1,1,1,1
2025_04_NO_BUF,2025,4,NO,19,BUF,31,12,50,0,15.5,11.508354772888564,0.49164522711143555,3.5,0.24171502934145503,12.25,1,1,1,1
2025_04_CLE_DET,2025,4,CLE,10,DET,34,24,44,0,10,10.916451681110392,13.083548318889608,14,171.1792366127191,196,1,1,1,1
2025_04_TEN_HOU,2025,4,TEN,0,HOU,26,26,26,0,7.5,3.413267170860412,22.58673282913959,18.5,510.16049989493206,342.25,1,1,0,0
2025_04_CAR_NE,2025,4,CAR,13,NE,42,29,55,0,5.5,3.999099709076454,25.000900290923543,23.5,625.045015356701,552.25,1,1,0,0
2025_04_LAC_NYG,2025,4,LAC,18,NYG,21,3,39,0,-6,-4.665256769315553,7.665256769315553,9,58.756161339537904,81,0,0,1,1
2025_04_PHI_TB,2025,4,PHI,31,TB,25,-6,56,0,-3.5,1.2229819748276745,7.222981974827675,2.5,52.171468608685494,6.25,0,1,0,0
2025_04_IND_LA,2025,4,IND,20,LA,27,7,47,0,3.5,-1.639564031164241,8.639564031164241,3.5,74.6420666485869,12.25,0,1,0,0
2025_04_JAX_SF,2025,4,JAX,26,SF,21,-5,47,0,3.5,3.7936047991403945,8.793604799140395,8.5,77.32748536346499,72.25,0,0,0,0
2025_04_BAL_KC,2025,4,BAL,20,KC,37,17,57,0,-2.5,1.0125170625622042,15.987482937437797,19.5,255.5996106748647,380.25,1,0,1,1
2025_04_CHI_LV,2025,4,CHI,25,LV,24,-1,49,0,1.5,4.121681910851585,5.121681910851585,2.5,26.231625595944344,6.25,0,0,0,0
2025_04_GB_DAL,2025,4,GB,40,DAL,40,0,80,1,-7,-3.1884139597467125,3.1884139597467125,7,10.16598357870771,49,1,1,1,1
2025_04_NYJ_MIA,2025,4,NYJ,21,MIA,27,6,48,0,2.5,0.8414118525648691,5.158588147435131,3.5,26.611031674858214,12.25,1,1,0,0
2025_04_CIN_DEN,2025,4,CIN,3,DEN,28,25,31,0,7.5,1.1602529156925303,23.83974708430747,17.5,568.3335410437464,306.25,1,1,0,0
2025_05_SF_LA,2025,5,SF,26,LA,23,-3,49,1,8.5,3.4288053425290936,6.428805342529094,11.5,41.329538132130615,132.25,0,0,1,1
2025_05_MIN_CLE,2025,5,MIN,21,CLE,17,-4,38,0,-3.5,-6.513209301185983,2.513209301185982,0.5,6.316220991567735,0.25,1,1,1,0
2025_05_HOU_BAL,2025,5,HOU,44,BAL,10,-34,54,0,-2.5,2.207074191018842,36.20707419101884,31.5,1310.9522214739427,992.25,0,1,0,0
2025_05_MIA_CAR,2025,5,MIA,24,CAR,27,3,51,0,-1.5,-2.088607828991949,5.0886078289919485,4.5,25.893929637278152,20.25,0,0,0,0
2025_05_LV_IND,2025,5,LV,6,IND,40,34,46,0,7,7.414462212451305,26.585537787548695,27,706.7908194531796,729,1,1,1,1
2025_05_NYG_NO,2025,5,NYG,14,NO,26,12,40,0,1.5,2.0072882856904446,9.992711714309555,10.5,99.85428740529942,110.25,1,1,1,1
2025_05_DAL_NYJ,2025,5,DAL,37,NYJ,22,-15,59,0,1.5,3.823425313618396,18.823425313618397,16.5,354.32134053736985,272.25,0,0,0,0
2025_05_DEN_PHI,2025,5,DEN,21,PHI,17,-4,38,0,3.5,4.139420662301936,8.139420662301937,7.5,66.25016871790771,56.25,0,0,0,0
2025_05_TEN_ARI,2025,5,TEN,22,ARI,21,-1,43,0,7.5,7.017506278819882,8.017506278819882,8.5,64.28040693091623,72.25,0,0,1,1
2025_05_TB_SEA,2025,5,TB,38,SEA,35,-3,73,0,3.5,-0.04813304215500569,2.9518669578449943,6.5,8.71351853681706,42.25,1,0,1,1
2025_05_DET_CIN,2025,5,DET,37,CIN,24,-13,61,0,-10.5,-6.936561998782987,6.063438001217013,2.5,36.76528039460256,6.25,1,1,0,0
2025_05_WAS_LAC,2025,5,WAS,27,LAC,10,-17,37,0,2.5,4.326824044036602,21.3268240440366,19.5,454.83342380529774,380.25,0,0,0,0
2025_05_NE_BUF,2025,5,NE,23,BUF,20,-3,43,0,7.5,8.16779387292958,11.16779387292958,10.5,124.71961998824348,110.25,0,0,0,0
2025_05_KC_JAX,2025,5,KC,28,JAX,31,3,59,0,-3.5,-0.4724657000871586,3.4724657000871586,6.5,12.0580180382818,42.25,0,0,1,1
2025_06_PHI_NYG,2025,6,PHI,17,NYG,34,17,51,0,-7,-1.5407841307307768,18.540784130730778,24,343.7606761823582,576,0,0,1,1
2025_06_DEN_NYJ,2025,6,DEN,13,NYJ,11,-2,24,0,-7.5,-4.92980356455847,2.92980356455847,5.5,8.583748926899517,30.25,1,1,1,1
2025_06_LA_BAL,2025,6,LA,17,BAL,3,-14,20,0,-7,2.1141880387056533,16.114188038705652,7,259.6670561467643,49,0,1,0,0
2025_06_DAL_CAR,2025,6,DAL,27,CAR,30,3,57,0,-3,1.9925250496430704,1.0074749503569296,6,1.0150057755966977,36,1,0,1,1
2025_06_ARI_IND,2025,6,ARI,27,IND,31,4,58,0,8.5,4.884391570139316,0.8843915701393161,4.5,0.7821484493334849,20.25,1,1,1,1
2025_06_SEA_JAX,2025,6,SEA,20,JAX,12,-8,32,0,-1.5,1.0099428487962498,9.00994284879625,6.5,81.17907013857469,42.25,0,1,0,0
2025_06_LAC_MIA,2025,6,LAC,29,MIA,27,-2,56,0,-3.5,-0.12886894495406587,1.8711310550459341,1.5,3.5011314251573107,2.25,1,1,1,0
2025_06_NE_NO,2025,6,NE,25,NO,19,-6,44,0,-3.5,0.8782981188790333,6.878298118879034,2.5,47.310985012174854,6.25,0,1,0,0
2025_06_CLE_PIT,2025,6,CLE,9,PIT,23,14,32,0,5.5,3.0295280207350825,10.970471979264918,8.5,120.35125544783672,72.25,1,1,0,0
2025_06_TEN_LV,2025,6,TEN,10,LV,20,10,30,0,3.5,2.5642178217013196,7.43578217829868,6.5,55.29085660310427,42.25,1,1,0,0
2025_06_CIN_GB,2025,6,CIN,18,GB,27,9,45,0,14,8.956685905374819,0.0433140946251811,5,0.001876110793199142,25,1,1,1,1
2025_06_SF_TB,2025,6,SF,19,TB,30,11,49,0,3.5,4.510086187585838,6.489913812414162,7.5,42.11898129256412,56.25,1,1,1,1
2025_06_DET_KC,2025,6,DET,17,KC,30,13,47,0,2.5,-0.9440081619594504,13.94400816195945,10.5,194.43536362079178,110.25,0,1,0,0
2025_06_BUF_ATL,2025,6,BUF,14,ATL,24,10,38,0,-3.5,-0.9237629940327574,10.923762994032757,13.5,119.32859794979949,182.25,0,0,1,1
2025_06_CHI_WAS,2025,6,CHI,25,WAS,24,-1,49,0,5.5,5.885291271817199,6.885291271817199,6.5,47.4072358977621,42.25,0,0,0,0
